5 5
1, 1, 2, 2, 2, 
1, 2, 2, 1, 2, 
2, 2, 1, 1, 8, 
2, 1, 1, 4, 1, 
2, 2, 2, 2, 2, 
