51 51
2 2 1 1 2 2 2 2 1 1 2 2 2 2 2 2 2 2 1 1 2 2 2 2 2 2 1 2 2 2 1 2 2 2 2 1 1 1 1 1 1 1 2 2 1 2 2 2 1 2 2 
2 1 2 2 2 1 2 1 2 2 2 1 1 2 1 1 1 2 2 2 2 1 1 1 2 1 2 2 1 2 1 2 1 1 2 2 1 1 1 1 1 2 2 1 1 2 1 2 2 2 1 
2 2 2 1 1 2 2 1 2 1 1 2 2 2 1 2 1 1 1 1 1 2 2 2 2 2 2 1 2 2 2 2 1 2 1 2 2 1 1 1 2 2 1 1 2 2 1 2 1 2 2 
2 1 1 2 2 2 1 1 2 1 2 1 2 1 2 2 2 2 2 2 1 2 1 1 1 1 1 2 1 2 1 1 2 2 2 1 2 2 1 2 2 1 2 2 2 1 1 2 2 1 2 
1 2 2 2 1 1 2 2 2 2 2 1 2 2 1 1 1 1 1 2 2 2 1 2 2 2 2 2 2 1 2 1 1 2 1 2 2 1 2 2 1 2 2 1 1 2 2 1 2 1 1 
1 2 1 2 2 1 2 1 1 1 1 1 1 2 2 2 2 2 2 1 1 1 2 2 1 1 1 1 2 1 2 2 2 2 1 2 1 2 2 1 2 2 1 2 1 2 1 1 2 2 2 
2 2 1 1 1 1 2 1 2 2 2 1 1 2 1 2 1 1 2 1 2 2 2 1 2 2 2 1 2 2 1 2 1 2 2 2 2 2 1 2 1 2 1 2 2 2 1 2 1 1 2 
2 1 2 2 2 2 2 1 2 1 2 2 2 1 1 1 1 2 2 1 2 1 1 2 1 1 2 2 1 2 2 1 1 2 1 1 2 1 2 2 2 2 1 2 1 2 2 2 2 1 2 
2 2 2 1 1 1 1 1 2 2 1 1 2 2 1 2 2 2 1 1 2 1 2 2 2 1 1 2 2 1 2 2 2 1 2 2 1 1 2 1 2 1 2 2 2 1 2 1 2 1 2 
1 2 1 2 2 2 2 2 2 1 2 2 2 1 2 2 1 1 1 2 2 1 2 1 2 2 1 1 2 2 1 1 2 2 2 1 2 2 2 1 1 2 2 1 2 2 1 2 2 1 2 
2 2 2 1 2 1 1 2 1 2 2 1 1 2 2 1 1 2 2 2 1 2 2 1 1 2 2 2 2 1 2 2 1 1 2 2 2 1 1 2 2 2 1 2 2 1 2 2 1 2 2 
2 1 2 1 2 2 2 1 1 1 2 2 2 1 2 2 2 2 1 1 2 2 1 2 2 1 1 1 2 2 2 1 2 2 1 1 1 2 2 2 1 1 2 2 1 2 2 1 2 2 1 
2 2 1 2 1 1 2 2 1 2 2 1 1 2 2 1 2 1 2 2 2 1 2 2 1 2 2 2 1 1 2 1 1 2 1 2 2 2 1 2 2 2 1 1 2 2 1 2 1 2 2 
1 2 2 2 2 2 1 2 1 2 1 2 2 2 1 2 2 1 2 1 2 1 2 1 2 2 1 2 1 2 2 2 1 2 2 2 1 1 2 1 1 2 2 2 1 2 2 2 1 2 1 
2 1 1 2 1 1 2 2 1 2 2 1 2 1 2 1 2 2 1 2 2 1 2 1 2 1 2 2 2 1 1 2 1 1 2 1 1 2 2 2 2 1 1 2 1 2 1 2 1 2 2 
2 2 1 2 2 1 2 1 2 1 2 2 1 1 2 2 1 2 1 2 1 2 2 2 2 1 2 1 2 2 1 2 2 2 1 1 2 2 1 1 2 2 1 2 1 2 2 1 2 2 1 
2 1 2 1 2 1 2 1 2 2 1 2 2 2 1 2 2 2 1 2 2 1 2 1 2 2 1 1 1 2 2 1 1 2 2 2 2 1 2 2 1 2 2 2 1 1 1 1 2 1 1 
2 2 2 2 2 1 2 2 1 2 2 1 1 2 1 2 1 1 1 1 2 2 1 2 1 2 2 1 2 2 1 1 2 1 2 1 2 2 1 2 2 1 1 1 2 2 2 2 2 1 1 
2 1 1 2 1 2 2 1 2 1 2 1 2 2 1 2 1 2 1 2 1 2 1 2 2 1 2 1 2 1 1 2 2 1 2 1 1 2 2 1 2 2 2 1 2 1 2 1 2 2 1 
2 1 4 1 2 2 1 2 2 1 2 1 2 1 2 2 1 2 2 2 2 2 1 1 2 2 2 1 2 2 2 2 1 1 2 2 2 1 1 2 2 1 2 1 2 2 1 2 1 2 2 
2 1 2 2 1 2 2 2 1 2 2 1 2 2 1 2 2 2 1 1 1 1 2 2 2 1 1 2 2 1 2 1 2 2 1 2 1 2 2 2 1 2 2 2 1 2 1 2 2 1 2 
2 1 1 2 2 1 1 2 2 2 1 2 1 2 2 1 1 1 2 2 2 1 2 1 2 1 8 1 2 1 2 1 1 2 2 2 1 2 1 1 1 2 1 2 1 2 1 2 1 2 2 
2 2 2 1 2 2 2 1 1 2 1 2 2 1 2 2 2 1 2 1 2 1 1 2 1 1 2 1 2 1 2 2 1 2 1 2 1 2 2 2 2 1 2 2 2 2 1 2 2 1 2 
1 1 2 2 1 2 1 2 1 2 2 2 1 2 1 1 2 2 2 1 2 2 2 2 2 2 2 1 2 2 1 2 2 1 2 2 1 2 1 1 2 1 2 1 1 1 2 2 1 2 2 
2 2 1 2 1 2 2 2 2 1 1 2 2 2 2 2 1 1 1 2 1 1 1 1 2 1 1 1 1 2 1 1 2 1 2 1 2 1 2 1 2 2 1 2 2 2 2 1 2 2 1 
2 1 1 2 2 1 1 2 1 2 1 1 1 2 1 2 2 2 1 2 1 2 2 2 1 2 2 1 2 1 2 2 2 1 2 1 2 2 2 2 1 2 1 2 1 1 2 1 2 1 1 
2 1 2 1 2 1 2 2 1 2 2 2 1 2 2 1 2 1 2 2 2 2 1 2 2 1 2 2 2 2 2 1 1 2 2 2 2 1 2 1 2 2 1 2 2 2 1 1 2 2 1 
2 2 2 1 2 2 1 2 2 2 1 2 2 1 2 2 1 2 2 1 1 1 1 1 2 2 1 2 1 1 1 2 2 2 1 2 1 2 1 2 2 1 1 2 1 2 2 2 1 2 2 
2 1 2 2 1 2 2 1 2 1 2 1 2 2 1 2 1 2 1 2 2 2 1 1 2 1 2 2 1 2 2 2 1 1 2 1 2 2 2 1 2 2 2 1 2 2 1 2 2 1 2 
2 2 1 2 1 1 2 2 1 2 2 2 2 1 1 2 2 2 1 2 1 2 2 2 2 1 2 1 1 2 1 1 2 2 2 1 2 1 2 1 2 1 2 1 2 1 1 2 1 1 2 
2 1 2 2 2 2 1 2 2 1 2 1 2 1 2 1 1 1 2 2 2 1 1 1 1 2 2 2 2 2 1 2 2 1 2 1 2 1 2 1 1 1 2 2 1 2 2 2 1 2 2 
2 2 1 1 1 2 2 2 1 2 2 1 2 2 2 2 2 1 2 1 2 1 2 2 1 2 1 1 1 2 1 2 1 2 2 1 2 1 2 2 2 2 2 1 2 2 1 1 2 2 1 
1 2 2 2 2 1 1 1 2 2 1 2 2 1 1 1 2 2 1 2 2 2 1 2 1 2 2 2 2 1 2 2 1 2 1 2 2 1 1 1 1 2 1 2 2 1 2 2 2 1 2 
2 1 1 2 1 2 2 2 1 2 1 1 1 2 2 2 1 2 2 1 1 2 1 2 2 1 1 1 2 2 2 1 2 2 1 2 1 2 2 2 2 1 2 1 2 2 1 2 1 1 2 
2 2 1 2 1 1 2 1 2 2 2 2 2 1 1 2 2 2 1 2 2 2 1 1 2 2 2 2 1 1 1 2 2 1 2 2 1 2 1 1 2 2 2 2 1 2 1 2 1 2 2 
1 2 1 2 2 1 2 2 2 1 1 1 2 1 2 2 1 1 2 2 1 1 2 2 2 1 1 2 1 2 2 2 1 2 2 1 1 2 2 2 1 1 1 2 1 2 2 2 1 2 1 
2 2 2 1 2 1 1 2 1 2 2 2 2 1 2 1 2 2 2 1 1 2 2 1 2 2 1 1 2 2 1 1 2 2 1 1 2 1 1 2 1 2 1 2 1 2 1 1 2 2 2 
2 1 2 1 2 2 2 1 2 1 2 1 2 1 1 2 2 1 1 2 2 2 1 1 1 2 2 2 2 1 2 2 2 1 2 2 2 2 1 2 1 2 1 2 1 2 2 1 2 1 2 
1 2 2 2 1 1 2 1 2 2 2 1 2 2 1 2 1 2 2 2 1 2 1 1 2 1 1 2 1 2 2 1 1 2 2 1 2 1 2 2 1 2 1 2 1 1 2 1 1 2 2 
2 2 1 1 2 2 2 1 2 1 2 2 1 2 1 2 2 1 2 1 2 2 2 2 2 1 2 1 2 2 1 1 2 1 2 1 2 1 2 1 2 2 1 2 2 1 2 2 2 2 1 
1 2 2 2 2 1 1 1 2 2 1 2 2 1 2 1 2 2 1 2 2 1 1 1 2 1 2 1 2 1 2 2 2 2 2 1 2 1 2 2 1 2 2 1 2 2 1 2 1 2 2 
1 2 1 2 1 2 2 2 1 1 2 1 2 2 2 2 1 2 1 1 2 1 2 1 2 1 2 1 2 2 1 2 1 1 2 1 2 2 1 2 2 1 2 1 2 1 2 1 2 2 1 
2 2 1 1 2 2 1 2 2 2 2 2 1 2 1 2 1 2 2 2 1 2 2 1 2 1 2 2 1 2 1 2 1 2 1 2 2 1 1 1 2 1 2 1 2 2 2 2 2 1 2 
2 1 2 2 2 1 2 1 1 2 1 2 1 2 1 2 2 1 1 2 1 2 1 2 2 1 2 1 2 2 1 2 2 2 2 1 2 2 1 2 2 1 2 1 1 2 1 1 1 2 2 
2 1 2 1 1 2 2 2 2 1 2 2 1 1 1 1 2 2 1 2 1 2 2 2 1 2 2 1 2 1 1 1 2 1 2 2 1 2 1 2 1 2 2 2 2 1 2 2 2 1 2 
2 2 2 1 2 1 2 1 2 2 1 2 2 2 1 2 1 2 1 2 1 2 1 1 2 2 1 2 2 1 1 2 2 2 1 2 2 1 1 2 2 1 2 1 2 1 2 1 2 2 2 
1 2 1 2 2 2 2 2 1 1 2 1 1 2 1 2 2 2 1 2 1 2 2 2 2 1 2 2 1 2 2 2 1 1 2 1 2 2 2 1 2 1 1 2 2 2 2 2 1 1 2 
2 2 1 2 1 1 1 2 2 2 2 2 1 2 2 1 2 1 1 2 2 1 1 2 1 2 2 1 1 2 1 1 2 2 2 1 1 1 2 2 2 2 2 1 2 1 2 1 2 2 2 
2 1 2 2 2 2 2 1 2 1 1 2 2 1 2 1 2 2 2 1 2 2 2 1 1 2 1 2 2 2 1 2 2 1 2 2 2 2 1 1 2 1 2 2 1 2 2 1 2 1 2 
1 2 2 1 1 1 2 1 1 2 1 2 1 2 2 2 1 2 1 2 1 1 2 1 2 2 1 1 2 1 2 2 1 2 1 1 1 2 1 2 1 2 1 2 2 1 1 2 2 1 2 
2 2 1 2 2 2 2 2 2 2 1 2 2 2 1 2 2 2 2 2 2 1 2 2 2 1 2 2 2 2 2 1 2 2 2 2 2 2 2 2 2 2 2 1 2 2 2 2 1 2 2 
